16
16
5555555555555555
5   E          5
5           E  5
2222223   122222
8888889   788888
5555555   555555
5555555   555555
vvvvvvv   vvvvvv
5              5
5              5
5   P          5
5           D  5
5              5
5              5
5              5
5555555555555555