16
16
5555555555555555
5              5
5           E  5
2222223   122222
8888889bbb788888
5555555BBB555555
5555555BBB555555
vvvvvvvBBBvvvvvv
5              5
5              5
5   P          5
5           D  5
5              5
5              5
5              5
5555555555555555