8
10
########
#      #
#  P   #
#      #
#      #
#    D #
#      #
#      #
#      #
########