15
10
###############
# E           #
#         P   #
#             #
#             #
#           D #
#             #
#             #
#             #
###############