15
10
###############
# E           #
#         P   #
#             #
#             #
#     E     D #
#             #
#             #
#  E          #
###############