16
16
                
                
                
                
   55555555555  
   5P       D5  
   5         5  
   5         5  
   5         5  
   5         5  
   5         5  
   5         5  
   5         5  
 5555        5  
  5555       5  
 5555555555555  