16
16
                
                
                    
     P           
   55555555555  
   5  E     D5  
   5    E    5  
   5         5  
             5  
   5         5  
   5         5  
   5         5  
   5         5  
 5555        5  
  5555       5  
 5555555555555  