16
16
vvvvvvvvvvvvvvvv
BBB            4
6          EB  4
6         BBB  4
6              4
6              4
6              4
6   B          4
6              4
6              4
6              4
6              4
6  P          D4
6              4
6              4
7888888888888889