16
16
0Ő888ÚŐ888ÚŐ888Ú
04   64   64   6
Ő9 E 79 E 79 D 6
45b b55b b55b b6
4vB B55B B55B B6
45B BvvB BvvB B6
4              6
4              6
4           E  6
4              6
4bb   bbbb   bb6
4BB   BBBB   BB6
4BB   BBBB   BB6
4              6
4       P      6
Á22222222222222Ű