16
16
vvvvvvvvvvvvvvvv
6P          55 v
6        5BB5E 4
6              4
6   5B        54
6   5E55   B   4
6      B  BB5  4
6          5   4
6  5B          4
6   5  5    BBB4
6      BE   B D4
6      5B5  B  4
6 BB     5 EB  4
6 5            4
6E5            4
7888888888888889